0  0  0  0  0  0  0  0  0
0  1  1  1  0  1  1  1  0
0  1  0  0  0  0  0  1  0
0  1  0  1  1  1  0  1  0
11 0  0  1  21 1  0  0  12
0  1  0  1  1  1  0  1  0
0  1  0  0  0  0  0  1  0
0  1  1  1  0  1  1  1  0
0  0  0  0  22 0  0  0  0